~~~~~~~~~~~~~~~~~~~~~~~~~~~~~~~~
...~~~~.........................
0 ..~~..            2           
.  ....           ....          
. *        *      .~~.          
....              .~~.          
.~~.              ....          
.~~.               *            
....      1 ....          3     
           ..~~..               
............~~~~................
~~~~~~~~~~~~~~~~~~~~~~~~~~~~~~~~